111111111111111111111111111
100000000000000C00000000001
10100101001000E010010101111
101001001010100000100010101
1P0000000C00C000000000000C1
111111111111111111111111111