1111111111111111111111111111111111
100000000000000C00000C000000000001
10100101001000E010100100Y000010101
1010010010101000001001000000010101
1P0000000C00C00000000000Y0000000C1
1111111111111111111111111111111111