1111111111111
1001000000011
1000EECC01101
10001110CP101
1111111111111