1111111111111
1001000000011
10000E1111001
1P00111000C01
1111111111111