1111111111111111111111111111111111
1E0000000000000C00000C000000000001
1010010100100000101001Y00000Y10101
101001001010101000Y001000000010101
1P000Y000C00C0000Y0000000Y000000C1
1111111111111111111111111111111111